111111111111111111111111111
10000000001C10000000C000011
1000E00001C0000000000000111
1000000000111000CC0C0C11111
110000000000000000C00100011
1000000P0000000000000000111
111111111111111111111111111