111111111111111
100000000010001
1000X000001C001
100000000011111
10000000000C001
100000000000001
1000000P0000001
111111111111111