111111111111111111111111111
10000000001C10000000C000001
1000E00001C0000000000000001
1000000000111000CC0C0C11111
100000000000000000C00100001
1000000P0000000000000000001
111111111111111111111111111