111111111111111111111111111
100000000010100000000000001
1000E0000100000000000000001
10000000001110000C000000111
100000000000000000000011111
100000000000000000000100001
1000000P0000000000000000001
111111111111111111111111111